[
  ["B", "B", "B", "B", "B", "B", "B"],
  ["B", " ", " ", " ", " ", " ", "B"],
  ["B", " ", " ", "X", " ", " ", "B"],
  ["B", " ", " ", " ", " ", " ", "B"],
  ["B", " ", " ", " ", " ", " ", "B"],
  ["B", " ", "B", "B", "B", "B", "B"]
]